 /$$$$$$$  /$$   /$$ /$$   /$$  /$$$$$$  /$$$$$$$$  /$$$$$$  /$$   /$$
| $$__  $$| $$  | $$| $$$ | $$ /$$__  $$| $$_____/ /$$__  $$| $$$ | $$
| $$  \ $$| $$  | $$| $$$$| $$| $$  \__/| $$      | $$  \ $$| $$$$| $$
| $$  | $$| $$  | $$| $$ $$ $$| $$ /$$$$| $$$$$   | $$  | $$| $$ $$ $$
| $$  | $$| $$  | $$| $$  $$$$| $$|_  $$| $$__/   | $$  | $$| $$  $$$$
| $$  | $$| $$  | $$| $$\  $$$| $$  \ $$| $$      | $$  | $$| $$\  $$$
| $$$$$$$/|  $$$$$$/| $$ \  $$|  $$$$$$/| $$$$$$$$|  $$$$$$/| $$ \  $$
|_______/  \______/ |__/  \__/ \______/ |________/ \______/ |__/  \__/